"a" = (/turf/wall/grass,/area/outside)
"b" = (/turf/floor/grass,/area/outside)
"c" = (/turf/wall/wood,/area/inside)
"d" = (/turf/floor/stone,/area/outside)
"e" = (/turf/floor/dirt,/area/outside)
"f" = (/obj/start,/turf/floor/wood,/area/inside)
"g" = (/turf/floor/mud,/area/outside)
"h" = (/turf/floor/wood,/area/inside)
"i" = (/obj/mirror,/turf/floor/wood,/area/inside)
"j" = (/obj/door,/turf/floor/wood,/area/inside)

(1,1,1) = {"
aaaaaaaaaaaaaaaaaaaa
abbbbbbbbbbbbbbbbbba
abbcccccddbeeeeeeeba
abbcfhicddbeeeeeeeba
abbchhhcddbbbbbbbbba
abbchhhjddbeeeeeeeba
abbchhhcddbeeeeeeeba
abbchhhcddbbbbbbbbba
abbcccccddbeeeeeeeba
abbbbbbbbbbeeeeeeeba
abbbbbbbbbbbbbbbbbba
abbbbbbbbbbbbbbbbbba
abbbbbbbbbbbbbbbbbba
abbggggggbbbbbbbbbba
abbggggggbbbbbbbbbba
abbggggggbbbbbbbbbba
abbggggggbbbbbbbbbba
abbggggggbbbbbbbbbba
abbbbbbbbbbbbbbbbbba
aaaaaaaaaaaaaaaaaaaa
"}
