"a" = (/turf/wall/grass,/area)
"b" = (/turf/floor/grass,/area)
"c" = (/turf/wall/wood,/area)
"d" = (/turf/floor/stone,/area)
"e" = (/turf/floor/dirt,/area)
"f" = (/turf/floor/wood,/area)
"g" = (/turf/floor/mud,/area)
"h" = (/obj/start,/turf/floor/wood,/area)
"i" = (/obj/door,/turf/floor/wood,/area)
"j" = (/obj/mirror,/turf/floor/wood,/area)

(1,1,1) = {"
aaaaaaaaaaaaaaaaaaaa
abbbbbbbbbbbbbbbbbba
abbcccccddbeeeeeeeba
abbchfjcddbeeeeeeeba
abbcfffcddbbbbbbbbba
abbcfffiddbeeeeeeeba
abbcfffcddbeeeeeeeba
abbcfffcddbbbbbbbbba
abbcccccddbeeeeeeeba
abbbbbbbbbbeeeeeeeba
abbbbbbbbbbbbbbbbbba
abbbbbbbbbbbbbbbbbba
abbbbbbbbbbbbbbbbbba
abbggggggbbbbbbbbbba
abbggggggbbbbbbbbbba
abbggggggbbbbbbbbbba
abbggggggbbbbbbbbbba
abbggggggbbbbbbbbbba
abbbbbbbbbbbbbbbbbba
aaaaaaaaaaaaaaaaaaaa
"}
